    Mapa teste:
    
    
    "#########################################",
    "#      ##################################",
    "##     ##################################",
    "##     ##################################",
    "#####      ##############################",
    "#####          ##########################",
    "############## ##########################",
    "############## ####          ############",
    "############## ####          ############",
    "############## ######## #################",
    "##############                 ##########",
    "##########   # ##########################",
    "##########   # #######        ###########",
    "##########             ##################",
    "##########   # ##########################",
    "##########   # ##########################",
    "##############       # ####   ###########",
    "#################### # ####     #########",
    "#######   ####    ## # ####      ########",
    "#######   ####    ## #           ########",
    "#######              # ####      ########",
    "#######   ####    ## # ####      ########",
    "#######   ####    ## # ####    ##########",
    "##############    ##   ##################",
    "#########################################"